handle	country
simpleplan	Canada
lyzabethlopex	Canada
propertybrothers	Canada
laurdiy	Canada
matthewsantoro	Canada
thebunnymomma	Canada
zanfa	Brazil
Ravanha69	Brazil
rodpocket	Brazil
twittzendo	Brazil
garciahiago	Brazil
Febatista	Brazil
5gu	Brazil
mikeavelico	Brazil
danilo_sanches	Brazil
naotefresqueia	Brazil
Luiz1227_	Brazil
murilocardoso	Brazil
pqpvoces	Brazil
revelandoverso	Brazil
luualvesup	Brazil
verineas	Brazil
poxaduduh	Brazil
PedroMiranda14	Brazil
aborteiro	Brazil
felipezando	Brazil
humdaora	Brazil
cinepop	Brazil
aeciodepapelao	Brazil
MarianaBelem	Brazil
luscas	Brazil
mrcoaurelio	Brazil
ollgotica	Brazil
brunofabil	Brazil
itspedrito	Brazil
lpfeelipe	Brazil
williianss	Brazil
marcoscastro	Brazil
oficialalailton	Brazil
MultiChato	Brazil
lordevoidemort	Brazil
chernoca	Brazil
iahgos	Brazil
dramatizaw	Brazil
RealMarioBrasil	Brazil
SerpaMichel	Brazil
SenhorSatanas	Brazil
Smillepls	Brazil
tofumandocrack	Brazil
afonso3d	Brazil
relatojovens	Brazil
DaviSantanaBr	Brazil
euidiotices	Brazil
cabeludinhu	Brazil
soumaravilhaa	Brazil
alinedaniellebg	Brazil
detremura	Brazil
luanlovato	Brazil
tadaora	Brazil
xuxanarecord	Brazil
Jhonatan_Peres	Brazil
Cleytu	Brazil
C4iO	Brazil
xuxanave	Brazil
Iamdanielcandia	Brazil
attackstyies	Brazil
comentv	Brazil
Umjovemzoas	Brazil
hygorfelipee	Brazil
Humberto	Brazil
zueirovcs	Brazil
eduardocilto	Brazil
fatodewhatsapp	Brazil
jeffersonline_	Brazil
jabutihigor	Brazil
louabusado	Brazil
hausofvitor	Brazil
algumgustavo	Brazil
LannesDelRey	Brazil
A_Pomba	Brazil
christian_fig	Brazil
meninobatman	Brazil
launcastro	Brazil
nathaanf_	Brazil
fatosex	Brazil
Trouxalizado	Brazil
jampa	Brazil
legalizandra	Brazil
Citaveis	Brazil
magnotizou	Brazil
neconery	Brazil
BRKsEDU	Brazil
SystemOfADio	Brazil
Whoiscarlos	Brazil
lanabebada	Brazil
isaacroosevelt	Brazil
musicascitou	Brazil
evelynregly	Brazil
LugasTV	Brazil
jornalistavitor	Brazil
twittferr	Brazil
adreanu	Brazil
vsfmael	Brazil
jbsizzler	Brazil
ProjetoJBTrick	Brazil
oficialnatinho	Brazil
MrWillSilva	Brazil
Complicarei	Brazil
UmDrogalizado	Brazil
vitoriasalim	Brazil
lullylucky	Brazil
renett_	Brazil
_satty	Brazil
taviao	Brazil
majutrindadef	Brazil
KIDRALWS	Brazil
rebeldeloved	Brazil
nuvencinza_	Brazil
TwittouFatos	Brazil
cuecavip	Brazil
Revoltalizado	Brazil
boulevard_vo	Brazil
lucasfelix	Brazil
ProfessorDum	Brazil
DoutorTrouxa	Brazil
SocrateSantana	Brazil
VoceNaoSabiaQ	Brazil
positividadediz	Brazil
recitoumpb	Brazil
desamei	Brazil
HumoroTal	Brazil
starkzoeiro	Brazil
reportercult	Brazil
isabelaafreitas	Brazil
projetooo	Brazil
Faveladofalou_	Brazil
arafamorena	Brazil
tarcisioramoss	Brazil
dieegosuficiel	Brazil
RecitouOriente	Brazil
chenriqqee_	Brazil
josias_brina	Brazil
claceloca	Brazil
BartCharmoso	Brazil
__hugorodrigues	Brazil
dnertv	Germany
unge	Germany
dagibee	Germany
bibisbeauty	Germany
taddl	Germany
iblali	Germany
apecrime	Germany
therealliont	Germany
melinasophie	Germany
julienco_	Germany
julien_bam	Germany
lefloid	Germany
germanletsplay	Germany
gronkh	Germany
shirindavid	Germany
rewinside	Germany
samislimani	Germany
paolamariaone	Germany
dimakoslowski	Germany
bergmanntogo	Germany
MissMalini	India
Zivame	India
SuperwomanII	India
AntoSharp	UK
arron_crascall	UK
Bencharmanart	UK
CheekyHoussein	UK
dapperlaughs	UK
daz_black	UK
DougieStew	UK
hash_tag_arthur	UK
HuwSamuel	UK
JoeOnVine	UK
LeslieWai	UK
Lsimmonds49	UK
MarkAllen321	UK
MarkTweeted	UK
OllieMcKendrick	UK
randall_toby	UK
SenanByrne	UK
the_stuggybear	UK
tom_harlock	UK